######################################
#P...#..##..#..#..#..##..#..###..##..###..##..##.#
##.##..#..###..#..#..###..##..#..#..###..#..###.#
#..###.###..#..##..#..###..###..##.###..###..##.#
#..#..#..#.#..###..##.###..###..###..###..###..##
#.#..##..#..##..#..###..##.##..#..###..#..#..#..#
###..#..##..##..#..###..#..###..###..##..#..###.#
#..#..#..###..#..#..##..###..#..###..##.###..#..##
#..#..###..##..###..#..###..#..##..###..###..###.#
##..#..#..##..###..###..#..#..#..##..###..#..###G#
#..#..###..###..##..#..###..##..#..###..###..###.#
#..###..###..#..##..#..###..###..#..#..##..###..##
#.#..#..###..##..###..#..#..##..#..#..###..#..###.#
##..###..##..##..##.###..#..#..##..##..##..###..##
#..#..#..#..##..##..#..#..##..###..###..#..##..##.#
###..##..###..#..##..#..###..#..###..##..#..#..#..#
#..##..###..#..#..##..#..###..##..#..##..#..##..##
##..##..#..#..##..#..#..##..#..##..###..###..##..##
#..#..##..###..#..##..#..###..#..#..#..###..##..##
##..###..#..#..###..#..###..##..###..###..###..##.#
#..##..#..#..##..#..#..###..#..##..###..#..#..#..##
#.#..##..##..###..###..###..#..#..##..##..#..###..#
##..###..#..###..#..#..###..#..#..#..##..##..###..#
#..###..###..###..###..#..#..###..###..#..#..#..##
#..#..##..#..#..###..###..##..##..##..#..#..#..###.#
######################################