####################
#...........#......#
#.#.#####.#.#.###.##
#.#.#.....#.#.....##
#.#.#.###.#.#.###.##
#.#.#.#...#.#.#...##
#...#.#.#####.#.####
#.###.#.........#..#
#...#.#.#######.#..#
####################