##########
#........#
#.##.##..#
#...P....#
#.##.##..#
#..G.....#
##########