####################
#P.......G..#......#
#.#.#####.#.#.###.##
#.#.#.....#.#.....##
#.#.#.###.#.#.###.##
#.#.#.#...#.#.#...##
#...#.#.#####.#.####
#.###.#...G....#..#
#...#.#.#######.#..#
####################